09x09;1
1;07,01
1;01,00
01,07
01,04,s
XXXXXXXXX
X       X
X       X
X       X
X       X
X       X
X       X
X       X
XXXXXXXXX