09x09;1
1;7,1
1;1,0
1,7
1,4,s
XXXXXXXXX
X       X
X       X
X       X
X       X
X       X
X       X
X       X
XXXXXXXXX